1 1 1 1 1 1 1 1 1 1 1 1 1 1 1 1
1 0 0 0 0 0 0 0 0 0 0 0 0 1 1 1
1 0 0 0 0 0 0 0 0 0 0 0 0 1 1 1
1 0 0 0 0 0 0 0 0 0 0 0 0 1 1 1
1 0 0 0 0 0 5 5 5 5 5 5 5 2 2 2
1 0 0 0 0 0 5 2 2 2 2 2 2 2 2 2
1 0 0 5 5 5 5 2 2 2 2 2 2 2 2 2
1 0 0 5 2 2 2 2 2 5 5 5 5 2 2 2
1 0 0 5 2 2 2 2 2 5 4 4 5 5 5 2
1 0 0 5 2 2 5 5 5 5 4 4 4 4 4 1
1 0 0 5 2 2 5 4 4 4 4 4 4 4 4 1
1 1 1 1 1 1 1 1 1 1 1 1 1 1 1 1